....................
....................
....................
....................
....................
....................
....................
....................
....................
....................
....................
....................
....................
....................
....................
#......#############
....................
....................
....................
....................
....................
....................
....................
....................
....................
....................
....................
##....##############
....................
....................
....................
....................
....................
....................
....................
....................
..####..............
....................
....................
....................
....................
....................
....................
....................
....................
####################
@@@@@@@@@@@@@@@@@@@@
@@@@@@@@@@@@@@@@@@@@
@@@@@@@@@@@@@@@@@@@@
@@@@@@@@@@@@@@@@@@@@
@@@@@@@@@@@@@@@@@@@@
@@@@@@@@@@@@@@@@@@@@