........
........
........
........
........
........
#......#
........
........
........
........
........
........
........
........
........
........
........
##....##
........
........
........
........
........
........
........
........
..####..
........
........
........
........
........
........
........
........
########
@@@@@@@@
@@@@@@@@
@@@@@@@@