........
........
........
........
........
........
........
........
.......#
........
........
........
........
........
........
.###....
........
........
........
........
......#.
........
........
........
........
........
........
........
########
@@@@@@@@
@@@@@@@@
@@@@@@@@
@@@@@@@@
@@@@@@@@
@@@@@@@@
@@@@@@@@
@@@@@@@@
@@@@@@@@
@@@@@@@@
@@@@@@@@