....................
....................
....................
....................
....................
....................
########....########
@@@@@@@@....@@@@@@@@
....................
....................
....................
....................
....................
....................
....................
....................
....................
....................
.......######.......
.......@@@@@@.......
....................
....................
....................
....................
....................
....................
....................
..#####......#####..
..@@@@@......@@@@@..
....................
....................
....................
....................
....................
....................
....................
....................
###....######....###
@@@....@@@@@@....@@@
....................
....................
....................
....................
....................
....................
....................
....................
####################
@@@@@@@@@@@@@@@@@@@@
@@@@@@@@@@@@@@@@@@@@
@@@@@@@@@@@@@@@@@@@@
@@@@@@@@@@@@@@@@@@@@