..........
..........
..........
..........
..........
..........
..........
..........
..........
..........
..........
..........
..........
..........
..........
..........
..........
..........
..........
..........
..........
..........
..........
..........
..........
..........
..........
..........
..........
..........
..........
..........
..........
..........
..........
..........
..........
##########
@@@@@@@@@@
..........
..........
..........
..........
..........
..........
..........
..........
##########
@@@@@@@@@@
@@@@@@@@@@
@@@@@@@@@@
@@@@@@@@@@
